1111111111111111111
1000000001000000001
1$110111010111011$1
1000000000000000001
1011010111110101101
1000010001000100001
1111011101011101111
###1010000000101###
1111010111110101111
00000001###10000000
1111010111110101111
###1010000000101###
1111010111110101111
1000000001000000001
1011011101011101101
10$100000*000001001
1101010111110101011
1000010001000100001
1011111101011111101
10000000000000000$1
1111111111111111111